|------------------------------------------------------------|
|                                                            |
|                                                            |
| AB                                                         |
|                                                            |
|                                                            |
|                                                            |
|                                                            |
|-----|                                                      |
|     |                                                      |
|     |                     B                                |
|     |                                                      |
|     |                                                      |
|     |                                                      |
|                                      C                     |
|                                                            |
|                     A                                      |
|                                                            |
|                                                            |
|                                                            |
|                                                            |
|                                                            |
|                                                            |
|                                                            |
|                                                            |
|                                                            |
|                                                            |
|                                                            |
|                                                            |
|                                                            |
|------------------------------------------------------------|
