|------------------------------------------------------------|
|                                                            |
|                                                            |
| AB                                                         |
|     |                                                      |
|     |                                                      |
|     |-----------------------                               |
|     |                                                      |
|-----|                                                      |
|     |                                                      |
|     |                     B -----------------------        |
|     |                                                      |
|     |                                                      |
|     |                                                      |
|     -----------------------          C   ------------------|
|                                                            |
|                     A                                      |
|                                                            |
|                                           |                |
|                                           |                |
|                                           |                |
|                                           |                |
|-----------------------------              |                |
|                                           |                |
|                                           |                |
|                                           |                |
|                                           |                |
|                                           |                |
|                                           |                |
|                                           |                |
|------------------------------------------------------------|
